А	а
Б	б
В	в
Г	г
Д	д
Е	е
Ё	ё
Ж	ж
З	з
И	и
Й	й
К	к
Л	л
М	м
Н	н
О	о
П	п
Р	р
С	с
Т	т
У	у
Ф	ф
Х	х
Ц	ц
Ч	ч
Ш	ш
Щ	щ
Ъ	ъ
Ы	ы
Ь	ь
Э	э
Ю	ю
Я	я

ЧАЩАХ ЮГА ЖИЛ БЫ ЦИТРУС? ДА, НО ФАЛЬШИВЫЙ ЭКЗЕМПЛЯР!
ЭХ, ЧУЖАК, ОБЩИЙ СЪЁМ ЦЕН ШЛЯП (ЮФТЬ) – ВДРЫЗГ!
ЛЮБЯ, СЪЕШЬ ЩИПЦЫ, — ВЗДОХНЁТ МЭР, — КАЙФ ЖГУЧ!
РАЗЪЯРЕННЫЙ ЧТЕЦ ЭГОИСТИЧНО БЬЁТ ПЯТЬЮ ЖЕРДЯМИ ШУСТРОГО ФЕХТОВАЛЬЩИКА.
НАШ БАНК ВЧЕРА ЖЕ ВЫПЛАТИЛ Ф.Я. ЭЙХГОЛЬДУ КОМИССИЮ ЗА ЦЕННЫЕ ВЕЩИ.

чащах юга жил бы цитрус? Да, но фальшивый экземпляр!
Эх, чужак, общий съём цен шляп (юфть) – вдрызг!
Любя, съешь щипцы, — вздохнёт мэр, — Кайф жгуч!
Разъяренный чтец эгоистично бьёт пятью жердями шустрого фехтовальщика.
Наш банк вчера же выплатил Ф.Я. Эйхгольду комиссию за ценные вещи.
